R 1400 900

NO ./textures/xpm/wall_1_512x512.xpm
SO ./textures/xpm/wall_2_512x512.xpm
WE ./textures/xpm/wall_3_512x512.xpm
EA ./textures/xpm/wall_4_512x512.xpm
S  ./textures/xpm/barrel.xpm

F	61,		43,		31
C	00,		51,		102

        1111111111111111111111111
        1000000000110000000000001
        1011000001110000000000001
        10010000000000000000000W1
111111111011000001110000000000001
100000000011000001110111110111111
11110111111111011100000010001
11110111111111011101010010001
11000000110101011100000010001
10002000000000001100000010001
10000000000000001101010010001
1100000111010101111101111000111
11110111 1110101 101111010001
11111111 1111111 111111111111
