R 1536 864

NO ./textures/xpm/walls/256/brick_wall_texture.xpm
SO ./textures/xpm/walls/256/wall_grey_rock.xpm
WE ./textures/xpm/walls/256/wall_brown_tiles.xpm
EA ./textures/xpm/walls/256/wall_white_rock.xpm
S  ./textures/xpm/sprites/box_2.xpm

F	./textures/xpm/floor_ceiling/256/floor_wood.xpm
C	./textures/xpm/floor_ceiling/256/ceiling_grey.xpm

                           1111111111111111111111111111111111111111111111111111111111
                           1000000000110000000000000000000000000000000000000000000001
                           1011000001110000002000000000000000000000000000000000000001
                           1001000000000000000000000000000000000000000000000000000001
                           1001000000000000000000000000000000000000000000000000000001
                           1001000000000000000000000000000000000000000000000000000001
                           1001000000000000000000000000000000000000000000000000000001
                           1001000000000000000000000000000000000000000000000000000001
                           1001000000000000000000000000000000000000000000000000000001
                           1001000000000000000000000000000000000000000000000000000001
                           1001000000000000000000000000000000000000000000000000000001
                           1001000000000000000000000000000000000000000000000000000001
                           1001000000000000000000000000000000000000000000000000000001
                           1001000000000000000000000000000000000000000000000000000001
                           1001000000000000000000000000000000000000000000000000000001
                           1001000000000000000000000000000000000000000000000000000001
                           1001000000000000000000000000000000000000000000000000000001
1111111111111111111111111111011000001110000000000000000000000000000000000000000000001
1000000000000000000000000000011000001110111110111111111111111111111111111111111111111
111111111111111111111110111111111011100000010001
111111111111111111111110111111111011101010010N01
110000000000000000000000000110101011100000010001
100000000000000000000002000000000001100000010001
100000000000000000000000000000000001101010010001
100000000000000000000000000000000001101010010001
100000000000000000000000000000000001101010010001
100000000000000000000000000000000001101010010001
100000000000000000000000000000000001101010010001
100000000000000000000000000000000001101010010001
100000000000000000000000000000000001101010010001
100000000000000000000000000000000001101010010001
100000000000000000000000000000000001101010010001
100000000000000000000000000000000001101010010001
11000000000000000000000000111010101111101111000111
111111111111111111111110111 1110101 101111010001
111111111111111111111111111 1111111 111111111111
