R 1536 864

NO ./textures/xpm/walls/256/brick_wall_texture.xpm
SO ./textures/xpm/walls/256/wall_grey_rock.xpm
WE ./textures/xpm/walls/256/wall_brown_tiles.xpm
EA ./textures/xpm/walls/256/wall_white_rock.xpm
S  ./textures/xpm/sprites/box_2.xpm

F	./textures/xpm/floor_ceiling/256/floor_wood.xpm
C	./textures/xpm/floor_ceiling/256/ceiling_grey.xpm

1111111111111111111111111111111111111111111
1000000000000000000000000000000000000000001
1000000000000000000000000000000000000000001
1000000000000000000000000000000000000000001
1000000000000000000000000000000000000000001
1000000000000000000000000000000000000000001
1000000000000000000000000000000000000000001
1000000000000000020000000000000000000000001
1000000000000000000000000000000000000000001
1000000000000000000000000000000000000000001
1000000000000000000000000000000000000000001
1000000000000000000000000000000000000000001
1000000000000000000000000000000000000000001
1000000000000000000000000000000000000000001
10000000000000000N0000000000000000000000001
1111111111111111111111111111111111111111111
