R 960 540

NO ./maps/test.cub
SO ./maps/test.cub
WE ./maps/test.cub
EA ./maps/test.cub
S  ./maps/test.cub

F	23,		64,		68
C	100,	200,	240

11111111111111111111
10000000001100000001
10110000011100000021
10010000000000000001
10110000011100000001
10110000011101111001
11000001110000001001
11000001110101001001
11010001110000001001
10000000010000001001
10000000010000001001
10000000010000000001
10000000010000000001
10000000010000001001
10000000010101001001
110101011111011110N1
 1110101 10111101001
 1111111 11111111111
