R 160 120

NO ./maps/test.cub
SO ./maps/test.cub
WE ./maps/test.cub
EA ./maps/test.cub
S  ./maps/test.cub

F	23,		64,		68
C	100,	200,	240

  111111
 1111W01  
 100201111  
  1111
