	R 1920 	1080  

  NO	 	./maps/test.cub
		SO	 	./maps/test.cub
			WE	 	./maps/test.cub
	EA	 	./maps/test.cub

	F  105,	128 , 255

	C 0, 188 , 25
      

		S    ./maps/test.cub
         1111
     1111W01  
     10020111   
      1111 
