R 1920 1080

NO ./maps/test.cub
SO ./maps/test.cub
WE ./maps/test.cub
EA ./maps/test.cub
S  ./maps/test.cub

F	23,		64,		68
C	100,	200,	240

        1111111111111111111111111
        1000000000110000000000001
        1011000001110000000000001
        1001000000000000000000001
111111111011000001110000000000001
100000000011000001110111110111111
11110111111111011100000010001
11110111111111011101010010001
11000000110101011100000010001
10002000000000001100000010001
10000000000000001101010010001
1100000111010101111101111000111
11110111 1110101 101111010N01
11111111 1111111 111111111111
