R 960 540

NO ./maps/test.cub
SO ./maps/test.cub
WE ./maps/test.cub
EA ./maps/test.cub
S  ./maps/test.cub

F	23,		64,		68
C	100,	200,	240

  111111
 1000W0111  
  1000001
 100000001
 100001001
 100201001  
  1111111
